14
38
XXXXXXXXXXXXXXXXXXXXXXXXXXXXXXXXXXXXXX
X                                    X
X                 XXXXXXXXXXXXXXXXX  X
X  XXXXXXXXXXXXXXXX       X          X
X  X                      X          X
X  XXXXXXXXXXXXXX         X          X
X                         X          X
XXXXXXXXXXXXXXXXX         XLXXXXXXXXXX
X                                    X
X  XXXX                              X
X     X                              X
X     X                              X
XXXXXXXXXXXXXXXXXXXXXXXXXXXXXXXXXXXXXX