00000000000000000000000000000000000000000000000000
01111111111111111111111111111111122111111111111110 
01111111111111111111111111111111221111111111111110
01111111111111111111111111111112211111111111111110
01111111111111111111111111111122111111111111111110
01111111111111111111111111111221111111111111111110
01111111111111111111111111112211111111111111111110
01111111111111111111111111122111111111111111111110
01111111111111111111111111221111111111111111111110 
01111111111111111111111112211111111111111111111110
01111111111111111111111122111111111111111111111110
01111111111111111111111221111111111111111111111110
01111111111111111111112211111111111111111111111110
01111111111111111111122111111111111111111111111110
01111111111111111111121111111111111111111111111110
01111111111111111111121111111111111111111111111110 
01111111111111111122222111111111111111111111111110
01111111111111111222222211111111111111111111111110
01111111111111111122222111111111111111111111111110
01111111111111111111111111111111111111111111111110
01111111111111111111111111111111111111111111111110
01111111111111111111111111111111111111111111111110
01111111111111111111111111111111111111111111111110 
01111111111111111111111111111111111111111111111110
01111111111111111111111111111111111111111111111110
01111111111111111111111111111111111111111111111110
01111111111111111111111111111111111111111111111110
01111111111111111111111111111111111111111111111110
01111111111111111111111111111111111111111111111110
01111111111111111111111111111111133331111111111110 
01111111111111111111111111111111133331111111111110
01111111111111111111111111111111143331111111111110
01111111111111111111111111111111133331111111111110
01111111111111111111111111111111111111111111111110
01111111111111111111111111111111111111111111111110
01111111111111111111111111111111111111111111111110
01111111111111111111111111111111111111111111111110 
01111111111111111111111111111111111111111111111110
01111111111111111111111111111111111111111111111110
01111111111111111111111111111111111111111111111110
01111111111111111111111111111111111111111111111110
01111111111111111111111111111111111111111111111110
01111111111111111111111111111111111111111111111110
01111111111111111111111111111111111111111111111110
01111111111111111111111111111111111111111111111110
01111111111111111111111111111111111111111111111110
01111111111111111111111111111111111111111111111110
01111111111111111111111111111111111111111111111110
01111111111111111111111111111111111111111111111110
00000000000000000000000000000000000000000000000000